敌空空空空空空空空空空空敌
空砖空砖空砖空砖空砖空砖空
空铁空铁空铁敌铁敌铁空铁空
敌砖空砖敌砖空砖空砖空砖敌
空铁空铁空铁空铁敌铁空铁空
空空敌空空空空空敌空空空敌
铁空水水敌空铁空空水水空铁
草草草草草砖草砖草草草草草
敌砖空砖空砖空砖空砖空砖敌
空砖空砖空砖空砖空砖空砖空
空砖空砖空空空空空砖空砖空
空空空空空空空空空空空空空
空空空空空空空空空空空空空